#############################
#.............#.............#
#.#####.#####.#.#####.#####.#
#.#...#.#...#.#.#...#.#.....#
#.#.#.#.#.#.#.#.#.#.#.#.#.#.#
#...#.....#.....#.....#...#.#
#####.##..#..A..#..##.#####.#
#.....#...#.....#...#.......#
#####.##..#.###.#..##.#####.#
#.#...#.....#.....#.....#...#
#.#.#.#.###.#.###.#.###.#.#.#
#...#...#...#.#...#...#...#.#
#.#####.#.###.#.###.#.#####.#
#.............#.............#
#############################